Австралия – Канберра
Антигуа и Барбуда – Сент-Джонс
Азербайджан – Баку
Алжир – Алжир
Австрия – Вена
Армения – Ереван
Албания – Тирана
Ангола – Луанда
Андорра – Андорра-ла-Велья
Аргентина – Буэнос-Айрес
Афганистан – Кабул
Беларусь – Минск
Бангладеш – Дакка
Барбадос – Бриджтаун
Бахрейн – Манама
Багамы – Нассау
Белиз – Бельмопан
Бразилия – Бразилиа
Бруней – Бандар-Сери-Багаван
Болгария – София
Боливия – Сукре
Босния и Герцеговина – Сараево
Бельгия – Брюссель
Бенин – Порто-Ново
Ботсвана – Габороне
Буркина-Фасо – Уагадугу
Бурунди – Бужумбура
Бутан – Тхимпху
Венесуэла – Каракас
Восточный Тимор – Дили
Вануату – Порт-Вила
Великобритания – Лондон
Венгрия – Будапешт
Вьетнам – Ханой
Ватикан – Ватикан
Габон – Либревиль
Гвинея – Конакри
Гаити – Порт-о-Пренс
Гамбия – Банжул
Гана – Аккра
Гайана – Джорджтаун
Гватемала – Гватемала
Гвинея-Бисау – Бисау
Греция – Афины
Германия – Берлин
Гондурас – Тегусигальпа
Гренада – Сент-Джорджес
Грузия – Тбилиси
Доминика – Розо
Дания – Копенгаген
Джибути – Джибути
Доминиканская Республика – Санто-Доминго
Египет – Каир
Зимбабве – Хараре
Замбия – Лусака
Ирак – Багдад
Израиль – Иерусалим
Индонезия – Джакарта
Иордания – Амман
Индия – Нью-Дели
Испания – Мадрид
Иран – Тегеран
Ирландия – Дублин
Исландия – Рейкьявик
Италия – Рим
Йемен – Сана
Казахстан – Астана
Кабо-Верде – Прая
Камерун – Яунде
Канада – Оттава
Киргизия – Бишкек
Катар – Доха
Камбоджа – Пномпень
Колумбия – Санта-Фе-де-Богота
Кения – Найроби
Кипр – Никосия
Кирибати – Южная Тарава
Куба – Гавана
Китай – Пекин
Коморы – Морони
Конго, республика – Браззавиль
Коста-Рика – Сан-Хосе
Конго, демократическая республика – Киншаса
Кот-д’Ивуар – Ямусукро
Кувейт – Эль-Кувейт
Лаос – Вьентьян
Латвия – Рига
Лесото – Масеру
Люксембург – Люксембург
Ливия – Триполи
Литва – Вильнюс
Либерия – Монровия
Ливан – Бейрут
Лихтенштейн – Вадуц
Малави – Лилонгве
Мавритания – Нуакшот
Мадагаскар – Антананариву
Маврикий – Порт-Луи
Македония – Скопье
Малайзия – Куала-Лумпур
Маршалловы Острова – Маджуро
Мали – Бамако
Мальдивы – Мале
Мальта – Валлетта
Монако – Монако
Марокко – Рабат
Мозамбик – Мапуту
Молдавия – Кишинев
Монголия – Улан-Батор
Мексика – Мехико
Мьянма – Найпьидо
Намибия – Виндхук
Непал – Катманду
Нигер – Ниамей
Науру – Ярен
Новая Зеландия – Веллингтон
Нидерланды – Амстердам
Никарагуа – Манагуа
Нигерия – Абуджа
Норвегия – Осло
Оман – Маскат
Объединенные Арабские Эмираты – Абу-Даби
Пакистан – Исламабад
Польша – Варшава
Панама – Панама
Папуа - Новая Гвинея – Порт-Морсби
Парагвай – Асунсьон
Палау – Мелекеок
Перу – Лима
Португалия – Лиссабон
Руанда – Кигали
Россия– Москва
Румыния – Бухарест
Сальвадор – Сан-Сальвадор
Северная Корея – Пхеньян
Сан-Марино – Сан-Марино
Сан-Томе и Принсипи – Сан-Томе
Саудовская Аравия – Эр-Рияд
Самоа – Апиа
Свазиленд – Мбабане
Сирия – Дамаск
Сейшелы – Виктория
Сенегал – Дакар
Сербия – Белград
Словения – Любляна
Сент-Винсент и Гренадины – Кингстаун
Сент-Китс и Невис – Бастер
Сент-Люсия – Кастри
Сингапур – Сингапур
Суринам – Парамарибо
Словакия – Братислава
США – Вашингтон
Соломоновы Острова – Хониара
Сомали – Могадишо
Судан – Хартум
Сьерра-Леоне – Фритаун
Таджикистан – Душанбе
Танзания – Додома
Таиланд – Бангкок
Тонга – Нукуалофа
Турция – Анкара
Тринидад и Тобаго – Порт-оф-Спейн
Тувалу – Фунафути
Тунис – Тунис
Того – Ломе
Туркмения – Ашхабад
Узбекистан – Ташкент
Украина – Киев
Уганда – Кампала
Уругвай – Монтевидео
Фиджи – Сува
Франция – Париж
Филиппины – Манила
Финляндия – Хельсинки
Федеративные штаты Микронезии – Паликир
Хорватия – Загреб
Центрально-Африканская Республика – Банги
Черногория – Подгорица
Чехия – Прага
Чили – Сантьяго
Чад – Нджамена
Шри-Ланка – Коломбо
Швейцария – Берн
Швеция – Стокгольм
Эквадор – Кито
Эритрея – Асмарэ
Экваториальная Гвинея – Малабо
Эфиопия – Аддис-Абеба
Эстония – Таллин
Южно-Африканская Республика – Претория
Южная Корея – Сеул
Япония – Токио
Ямайка – Кингстон
